REB = "setup/countries/rebels.txt"
PIR = "setup/countries/pirates.txt"
BAR = "setup/countries/barbarians.txt"
MER = "setup/countries/mercenaries.txt"

#Used A,B,C,D,E,F,G,H,I,J,K,L,M,N,O,P,R,S,T,V
#New:

#Nubia and Mejay
NAA = "setup/countries/modded/mNAA.txt"
NAB = "setup/countries/modded/mNAB.txt"
NAC = "setup/countries/modded/mNAC.txt"
NAD = "setup/countries/modded/mNAD.txt"
NAE = "setup/countries/modded/mNAE.txt"
NAF = "setup/countries/modded/mNAF.txt"
NAG = "setup/countries/modded/mNAG.txt"
NAH = "setup/countries/modded/mNAh.txt"
#Libya
LAA = "setup/countries/modded/mLAA.txt"
LAB = "setup/countries/modded/mLAB.txt"
LAC = "setup/countries/modded/mLAC.txt"
LAD = "setup/countries/modded/mLAD.txt"
LAE = "setup/countries/modded/mLAE.txt"
LAF = "setup/countries/modded/mLAF.txt"
#3rd Intermediate Period
EAA = "setup/countries/modded/mEAA.txt"
EAB = "setup/countries/modded/mEAB.txt"
EAC = "setup/countries/modded/mEAC.txt"
EAD = "setup/countries/modded/mEAD.txt"
EAE = "setup/countries/modded/mEAE.txt"
EAF = "setup/countries/modded/mEAF.txt"
EAG = "setup/countries/modded/mEAG.txt"
EAH = "setup/countries/modded/mEAH.txt"
EAI = "setup/countries/modded/mEAI.txt"
EAJ = "setup/countries/modded/mEAJ.txt"
EAK = "setup/countries/modded/mEAK.txt"
EAL = "setup/countries/modded/mEAL.txt"
EAM = "setup/countries/modded/mEAM.txt"
EAN = "setup/countries/modded/mEAN.txt"
EAO = "setup/countries/modded/mEAO.txt"
EAP = "setup/countries/modded/mEAP.txt"
EAR = "setup/countries/modded/mEAR.txt"
EAS = "setup/countries/modded/mEAS.txt"
EAT = "setup/countries/modded/mEAT.txt"
EAU = "setup/countries/modded/mEAU.txt"
EAW = "setup/countries/modded/mEAW.txt"
EAX = "setup/countries/modded/mEAX.txt"
EAY = "setup/countries/modded/mEAY.txt"
EAZ = "setup/countries/modded/mEAZ.txt"
EBA = "setup/countries/modded/mEBA.txt"
EBB = "setup/countries/modded/mEBB.txt"
EBC = "setup/countries/modded/mEBC.txt"
EBD = "setup/countries/modded/mEBD.txt"
EBE = "setup/countries/modded/mEBE.txt"
EBF = "setup/countries/modded/mEBF.txt"
EBG = "setup/countries/modded/mEBG.txt"
EBH = "setup/countries/modded/mEBH.txt"
EBI = "setup/countries/modded/mEBI.txt"
EBJ = "setup/countries/modded/mEBJ.txt"
EBK = "setup/countries/modded/mEBK.txt"
EBL = "setup/countries/modded/mEBL.txt"
EBM = "setup/countries/modded/mEBM.txt"
EBN = "setup/countries/modded/mEBN.txt"
#Habiru and the Levantine Team
JAA = "setup/countries/modded/mJAA.txt"
JAB = "setup/countries/modded/mJAB.txt"
JAC = "setup/countries/modded/mJAC.txt"
JAD = "setup/countries/modded/mJAD.txt"
JAE = "setup/countries/modded/mJAE.txt"
JAF = "setup/countries/modded/mJAF.txt"
JAG = "setup/countries/modded/mJAG.txt"
JAH = "setup/countries/modded/mJAH.txt"
JAI = "setup/countries/modded/mJAI.txt"
JAJ = "setup/countries/modded/mJAJ.txt"
JAK = "setup/countries/modded/mJAK.txt"
JAL = "setup/countries/modded/mJAL.txt"
JAM = "setup/countries/modded/mJAM.txt"
JAN = "setup/countries/modded/mJAN.txt"
JAO = "setup/countries/modded/mJAO.txt"
JAP = "setup/countries/modded/mJAP.txt"
JAR = "setup/countries/modded/mJAR.txt"
JAS = "setup/countries/modded/mJAS.txt"
JAT = "setup/countries/modded/mJAT.txt"
JAU = "setup/countries/modded/mJAU.txt"
JAW = "setup/countries/modded/mJAW.txt"
JAX = "setup/countries/modded/mJAX.txt"
JAY = "setup/countries/modded/mJAY.txt"
JAZ = "setup/countries/modded/mJAZ.txt"
JBA = "setup/countries/modded/mJBA.txt"
JBB = "setup/countries/modded/mJBB.txt"
JBC = "setup/countries/modded/mJBC.txt"
JBD = "setup/countries/modded/mJBD.txt"
JBE = "setup/countries/modded/mJBE.txt"
JBF = "setup/countries/modded/mJBF.txt"
JBG = "setup/countries/modded/mJBG.txt"
JBH = "setup/countries/modded/mJBH.txt"
JBI = "setup/countries/modded/mJBI.txt"
JBJ = "setup/countries/modded/mJBJ.txt"
JBK = "setup/countries/modded/mJBK.txt"
JBL = "setup/countries/modded/mJBL.txt"
JBM = "setup/countries/modded/mJBM.txt"
JBN = "setup/countries/modded/mJBN.txt"
JBO = "setup/countries/modded/mJBO.txt"
JBP = "setup/countries/modded/mJBP.txt"
JBR = "setup/countries/modded/mJBR.txt"
JBS = "setup/countries/modded/mJBS.txt"
JBT = "setup/countries/modded/mJBT.txt"
JBU = "setup/countries/modded/mJBU.txt"
JBW = "setup/countries/modded/mJBW.txt"
JBX = "setup/countries/modded/mJBX.txt"
JBY = "setup/countries/modded/mJBY.txt"
JBZ = "setup/countries/modded/mJBZ.txt"
JCA = "setup/countries/modded/mJCA.txt"
JCB = "setup/countries/modded/mJCB.txt"

#Neo Hittite states
HAA = "setup/countries/modded/mHAA.txt"
HAB = "setup/countries/modded/mHAB.txt"
HAC = "setup/countries/modded/mHAC.txt"
HAD = "setup/countries/modded/mHAD.txt"
HAE = "setup/countries/modded/mHAE.txt"
HAF = "setup/countries/modded/mHAF.txt"
HAG = "setup/countries/modded/mHAG.txt"
HAH = "setup/countries/modded/mHAH.txt"
HAI = "setup/countries/modded/mHAI.txt"
HAJ = "setup/countries/modded/mHAJ.txt"
HAK = "setup/countries/modded/mHAK.txt"
HAL = "setup/countries/modded/mHAL.txt"
HAM = "setup/countries/modded/mHAM.txt"
HAN = "setup/countries/modded/mHAN.txt"
HAO = "setup/countries/modded/mHAO.txt"
HAP = "setup/countries/modded/mHAP.txt"
HAR = "setup/countries/modded/mHAR.txt"
HAS = "setup/countries/modded/mHAS.txt"
HAT = "setup/countries/modded/mHAT.txt"
HAU = "setup/countries/modded/mHAU.txt"
HAW = "setup/countries/modded/mHAW.txt"
HAY = "setup/countries/modded/mHAY.txt"
HAZ = "setup/countries/modded/mHAZ.txt"
HBA = "setup/countries/modded/mHBA.txt"
HBB = "setup/countries/modded/mHBB.txt"
HBC = "setup/countries/modded/mHBC.txt"
HBD = "setup/countries/modded/mHBD.txt"
HBE = "setup/countries/modded/mHBE.txt"
HBF = "setup/countries/modded/mHBF.txt"
HBG = "setup/countries/modded/mHBG.txt"
HBH = "setup/countries/modded/mHBH.txt"
HBI = "setup/countries/modded/mHBI.txt"
HBJ = "setup/countries/modded/mHBJ.txt"
HBK = "setup/countries/modded/mHBK.txt"
HBL = "setup/countries/modded/mHBL.txt"
HBM = "setup/countries/modded/mHBM.txt"
HBN = "setup/countries/modded/mHBN.txt"
HBO = "setup/countries/modded/mHBO.txt"
HBP = "setup/countries/modded/mHBP.txt"
HBS = "setup/countries/modded/mHBS.txt"
HBT = "setup/countries/modded/mHBT.txt"
HBU = "setup/countries/modded/mHBU.txt"
HBW = "setup/countries/modded/mHBW.txt"
HBY = "setup/countries/modded/mHBY.txt"
HBZ = "setup/countries/modded/mHBZ.txt"
HCA = "setup/countries/modded/mHCA.txt"
HCB = "setup/countries/modded/mHCB.txt"
HCC = "setup/countries/modded/mHCC.txt"
HCD = "setup/countries/modded/mHCD.txt"
HCE = "setup/countries/modded/mHCE.txt"
HCF = "setup/countries/modded/mHCF.txt"
HCG = "setup/countries/modded/mHCG.txt"
HCH = "setup/countries/modded/mHCH.txt"
HCI = "setup/countries/modded/mHCI.txt"
HCJ = "setup/countries/modded/mHCJ.txt"

#Grecoids
GAA = "setup/countries/modded/mGAA.txt"
GAB = "setup/countries/modded/mGAB.txt"
GAC = "setup/countries/modded/mGAC.txt"
GAD = "setup/countries/modded/mGAD.txt"
GAE = "setup/countries/modded/mGAE.txt"
GAF = "setup/countries/modded/mGAF.txt"
GAG = "setup/countries/modded/mGAG.txt"
GAH = "setup/countries/modded/mGAH.txt"
GAI = "setup/countries/modded/mGAI.txt"
GAJ = "setup/countries/modded/mGAJ.txt"
GAK = "setup/countries/modded/mGAK.txt"
GAL = "setup/countries/modded/mGAL.txt"
GAM = "setup/countries/modded/mGAM.txt"
GAN = "setup/countries/modded/mGAN.txt"
GAO = "setup/countries/modded/mGAO.txt"
GAP = "setup/countries/modded/mGAP.txt"
GAR = "setup/countries/modded/mGAR.txt"
GAS = "setup/countries/modded/mGAS.txt"
GAT = "setup/countries/modded/mGAT.txt"
GAW = "setup/countries/modded/mGAW.txt"
GAY = "setup/countries/modded/mGAY.txt"
GAZ = "setup/countries/modded/mGAZ.txt"
GBA = "setup/countries/modded/mGBA.txt"
GBB = "setup/countries/modded/mGBB.txt"
GBC = "setup/countries/modded/mGBC.txt"
GBD = "setup/countries/modded/mGBD.txt"
GBE = "setup/countries/modded/mGBE.txt"
GBF = "setup/countries/modded/mGBF.txt"
GBG = "setup/countries/modded/mGBG.txt"
GBH = "setup/countries/modded/mGBH.txt"
GBI = "setup/countries/modded/mGBI.txt"
GBJ = "setup/countries/modded/mGBJ.txt"
GBK = "setup/countries/modded/mGBK.txt"
GBL = "setup/countries/modded/mGBL.txt"
GBM = "setup/countries/modded/mGBM.txt"
GBN = "setup/countries/modded/mGBN.txt"
GBO = "setup/countries/modded/mGBO.txt"
GBP = "setup/countries/modded/mGBP.txt"
GBR = "setup/countries/modded/mGBR.txt"
GBS = "setup/countries/modded/mGBS.txt"
GBT = "setup/countries/modded/mGBT.txt"
GBU = "setup/countries/modded/mGBU.txt"
GBW = "setup/countries/modded/mGBW.txt"
GBY = "setup/countries/modded/mGBY.txt"
GBZ = "setup/countries/modded/mGBZ.txt"
GCA = "setup/countries/modded/mGCA.txt"
GCB = "setup/countries/modded/mGCB.txt"
GCC = "setup/countries/modded/mGCC.txt"
GCD = "setup/countries/modded/mGCD.txt"
GCE = "setup/countries/modded/mGCE.txt"
GCF = "setup/countries/modded/mGCF.txt"
GCG = "setup/countries/modded/mGCG.txt"
GCH = "setup/countries/modded/mGCH.txt"
GCI = "setup/countries/modded/mGCI.txt"
GCJ = "setup/countries/modded/mGCJ.txt"
GCK = "setup/countries/modded/mGCK.txt"
GCL = "setup/countries/modded/mGCL.txt"
GCM = "setup/countries/modded/mGCM.txt"
GCN = "setup/countries/modded/mGCN.txt"
GCO = "setup/countries/modded/mGCO.txt"
GCP = "setup/countries/modded/mGCP.txt"
GCR = "setup/countries/modded/mGCR.txt"
GCS = "setup/countries/modded/mGCS.txt"
GCT = "setup/countries/modded/mGCT.txt"
GCU = "setup/countries/modded/mGCU.txt"
GCW = "setup/countries/modded/mGCW.txt"
GCY = "setup/countries/modded/mGCY.txt"
GCZ = "setup/countries/modded/mGCZ.txt"
GDA = "setup/countries/modded/mGDA.txt"
GDB = "setup/countries/modded/mGDB.txt"
GDC = "setup/countries/modded/mGDC.txt"
GDD = "setup/countries/modded/mGDD.txt"
GDE = "setup/countries/modded/mGDE.txt"
GDF = "setup/countries/modded/mGDF.txt"
GDG = "setup/countries/modded/mGDG.txt"
GDH = "setup/countries/modded/mGDH.txt"
GDI = "setup/countries/modded/mGDI.txt"
GDJ = "setup/countries/modded/mGDJ.txt"
GDK = "setup/countries/modded/mGDK.txt"
GDL = "setup/countries/modded/mGDL.txt"
GDM = "setup/countries/modded/mGDM.txt"
GDN = "setup/countries/modded/mGDN.txt"
GDO = "setup/countries/modded/mGDO.txt"
GDP = "setup/countries/modded/mGDP.txt"
GDR = "setup/countries/modded/mGDR.txt"
GDS = "setup/countries/modded/mGDS.txt"
GDT = "setup/countries/modded/mGDT.txt"
GDU = "setup/countries/modded/mGDU.txt"
GDW = "setup/countries/modded/mGDW.txt"
GDY = "setup/countries/modded/mGDY.txt"
GDZ = "setup/countries/modded/mGDZ.txt"
GEA = "setup/countries/modded/mGEA.txt"
GEB = "setup/countries/modded/mGEB.txt"
GEC = "setup/countries/modded/mGEC.txt"
GED = "setup/countries/modded/mGED.txt"
GEE = "setup/countries/modded/mGEE.txt"
GEF = "setup/countries/modded/mGEF.txt"
GEG = "setup/countries/modded/mGEG.txt"
GEH = "setup/countries/modded/mGEH.txt"
GEI = "setup/countries/modded/mGEI.txt"
GEJ = "setup/countries/modded/mGEJ.txt"
GEK = "setup/countries/modded/mGEK.txt"
GEL = "setup/countries/modded/mGEL.txt"
GEM = "setup/countries/modded/mGEM.txt"
GEN = "setup/countries/modded/mGEN.txt"
GEO = "setup/countries/modded/mGEO.txt"
GEP = "setup/countries/modded/mGEP.txt"
GER = "setup/countries/modded/mGER.txt"
GES = "setup/countries/modded/mGES.txt"
GET = "setup/countries/modded/mGET.txt"
GEU = "setup/countries/modded/mGEU.txt"
GEW = "setup/countries/modded/mGEW.txt"
GEY = "setup/countries/modded/mGEY.txt"
GEZ = "setup/countries/modded/mGEZ.txt"
GFA = "setup/countries/modded/mGFA.txt"
GFB = "setup/countries/modded/mGFB.txt"
GFC = "setup/countries/modded/mGFC.txt"
GFD = "setup/countries/modded/mGFD.txt"
GFE = "setup/countries/modded/mGFE.txt"
GFF = "setup/countries/modded/mGFF.txt"
GFG = "setup/countries/modded/mGFG.txt"
GFH = "setup/countries/modded/mGFH.txt"
GFI = "setup/countries/modded/mGFI.txt"
GFJ = "setup/countries/modded/mGFJ.txt"
GFK = "setup/countries/modded/mGFK.txt"
GFL = "setup/countries/modded/mGFL.txt"
GFM = "setup/countries/modded/mGFM.txt"
GFN = "setup/countries/modded/mGFN.txt"
GFO = "setup/countries/modded/mGFO.txt"
GFP = "setup/countries/modded/mGFP.txt"
GFR = "setup/countries/modded/mGFR.txt"
GFS = "setup/countries/modded/mGFS.txt"
GFT = "setup/countries/modded/mGFT.txt"
GFU = "setup/countries/modded/mGFU.txt"
GFW = "setup/countries/modded/mGFW.txt"
GFY = "setup/countries/modded/mGFY.txt"
GFZ = "setup/countries/modded/mGFZ.txt"
GGA = "setup/countries/modded/mGGA.txt"
GGB = "setup/countries/modded/mGGB.txt"
GGC = "setup/countries/modded/mGGC.txt"
GGD = "setup/countries/modded/mGGD.txt"
GGE = "setup/countries/modded/mGGE.txt"
GGF = "setup/countries/modded/mGGf.txt"
GGG = "setup/countries/modded/mGGG.txt"
GGH = "setup/countries/modded/mGGH.txt"
GGJ = "setup/countries/modded/mGGI.txt"
GGI = "setup/countries/modded/mGGJ.txt"
GGK = "setup/countries/modded/mGGK.txt"
GGL = "setup/countries/modded/mGGL.txt"
GGM = "setup/countries/modded/mGGM.txt"
GGN = "setup/countries/modded/mGGN.txt"
GGO = "setup/countries/modded/mGGO.txt"
GGP = "setup/countries/modded/mGGP.txt"
GGR = "setup/countries/modded/mGGR.txt"
GGS = "setup/countries/modded/mGGS.txt"
GGT = "setup/countries/modded/mGGT.txt"
GGU = "setup/countries/modded/mGGU.txt"
GGW = "setup/countries/modded/mGGW.txt"
GGY = "setup/countries/modded/mGGY.txt"
GGZ = "setup/countries/modded/mGGZ.txt"
GHA = "setup/countries/modded/mGHA.txt"
GHB = "setup/countries/modded/mGHB.txt"
GHC = "setup/countries/modded/mGHC.txt"
GHD = "setup/countries/modded/mGHD.txt"
GHE = "setup/countries/modded/mGHE.txt"
GHF = "setup/countries/modded/mGHF.txt"
GHG = "setup/countries/modded/mGHG.txt"
GHH = "setup/countries/modded/mGHH.txt"
GHI = "setup/countries/modded/mGHI.txt"
GHJ = "setup/countries/modded/mGHJ.txt"
GHK = "setup/countries/modded/mGHK.txt"
GHL = "setup/countries/modded/mGHL.txt"
#Chad Akkadians
AAA = "setup/countries/modded/mAAA.txt"
AAB = "setup/countries/modded/mAAB.txt"
AAC = "setup/countries/modded/mAAC.txt"
AAD = "setup/countries/modded/mAAD.txt"
AAE = "setup/countries/modded/mAAE.txt"
AAF = "setup/countries/modded/mAAF.txt"
AAG = "setup/countries/modded/mAAG.txt"
AAH = "setup/countries/modded/mAAH.txt"
AAI = "setup/countries/modded/mAAI.txt"
AAJ = "setup/countries/modded/mAAJ.txt"
AAK = "setup/countries/modded/mAAK.txt"
AAL = "setup/countries/modded/mAAL.txt"
AAM = "setup/countries/modded/mAAM.txt"
AAN = "setup/countries/modded/mAAN.txt"
AAO = "setup/countries/modded/mAAO.txt"
AAP = "setup/countries/modded/mAAP.txt"
AAR = "setup/countries/modded/mAAR.txt"
AAS = "setup/countries/modded/mAAS.txt"
AAT = "setup/countries/modded/mAAT.txt"
AAU = "setup/countries/modded/mAAU.txt"
AAW = "setup/countries/modded/mAAW.txt"
AAY = "setup/countries/modded/mAAY.txt"
AAZ = "setup/countries/modded/mAAZ.txt"
ABA = "setup/countries/modded/mABA.txt"
ABB = "setup/countries/modded/mABB.txt"
ABC = "setup/countries/modded/mABC.txt"
ABD = "setup/countries/modded/mABD.txt"
ABE = "setup/countries/modded/mABE.txt"
ABF = "setup/countries/modded/mABF.txt"
ABG = "setup/countries/modded/mABG.txt"
ABH = "setup/countries/modded/mABH.txt"
ABI = "setup/countries/modded/mABI.txt"
ABJ = "setup/countries/modded/mABJ.txt"
ABK = "setup/countries/modded/mABK.txt"
ABL = "setup/countries/modded/mABL.txt"
ABM = "setup/countries/modded/mABM.txt"
ABN = "setup/countries/modded/mABN.txt"
ABO = "setup/countries/modded/mABO.txt"
ABP = "setup/countries/modded/mABP.txt"
ABR = "setup/countries/modded/mABR.txt"
ABS = "setup/countries/modded/mABS.txt"
ABT = "setup/countries/modded/mABT.txt"
ABU = "setup/countries/modded/mABU.txt"
ABW = "setup/countries/modded/mABW.txt"
ABY = "setup/countries/modded/mABY.txt"
ABZ = "setup/countries/modded/mABZ.txt"
ACA = "setup/countries/modded/mACA.txt"
ACB = "setup/countries/modded/mACB.txt"
ACC = "setup/countries/modded/mACC.txt"
ACD = "setup/countries/modded/mACD.txt"
ACE = "setup/countries/modded/mACE.txt"
ACF = "setup/countries/modded/mACF.txt"
ACG = "setup/countries/modded/mACG.txt"
ACJ = "setup/countries/modded/mACJ.txt"
ACI = "setup/countries/modded/mACI.txt"
ACK = "setup/countries/modded/mACK.txt"
ACL = "setup/countries/modded/mACL.txt"
ACM = "setup/countries/modded/mACM.txt"
ACN = "setup/countries/modded/mACN.txt"
ACO = "setup/countries/modded/mACO.txt"
ACP = "setup/countries/modded/mACP.txt"
ACR = "setup/countries/modded/mACR.txt"
ACS = "setup/countries/modded/mACS.txt"
ACT = "setup/countries/modded/mACT.txt"
ACU = "setup/countries/modded/mACU.txt"
ACW = "setup/countries/modded/mACW.txt"
ACY = "setup/countries/modded/mACY.txt"
ACZ = "setup/countries/modded/mACZ.txt"
ADA = "setup/countries/modded/mADA.txt"
ADB = "setup/countries/modded/mADB.txt"
ADC = "setup/countries/modded/mADC.txt"
ADE = "setup/countries/modded/mADE.txt"
ADF = "setup/countries/modded/mADF.txt"
ADG = "setup/countries/modded/mADG.txt"
ADH = "setup/countries/modded/mADH.txt"
ADI = "setup/countries/modded/mADI.txt"
ADJ = "setup/countries/modded/mADJ.txt"
ADK = "setup/countries/modded/mADK.txt"
ADL = "setup/countries/modded/mADL.txt"
ADM = "setup/countries/modded/mADM.txt"
#Thracian
TAA = "setup/countries/modded/mTAA.txt"
TAB = "setup/countries/modded/mTAB.txt"
TAC = "setup/countries/modded/mTAC.txt"
TAD = "setup/countries/modded/mTAD.txt"
TAE = "setup/countries/modded/mTAE.txt"
TAF = "setup/countries/modded/mTAF.txt"
TAG = "setup/countries/modded/mTAG.txt"
TAH = "setup/countries/modded/mTAH.txt"
TAI = "setup/countries/modded/mTAI.txt"
TAJ = "setup/countries/modded/mTAJ.txt"
TAK = "setup/countries/modded/mTAK.txt"
TAL = "setup/countries/modded/mTAL.txt"
TAM = "setup/countries/modded/mTAM.txt"
TAN = "setup/countries/modded/mTAN.txt"
TAO = "setup/countries/modded/mTAO.txt"
TAP = "setup/countries/modded/mTAP.txt"
TAR = "setup/countries/modded/mTAR.txt"
TAS = "setup/countries/modded/mTAS.txt"
TAT = "setup/countries/modded/mTAT.txt"
TAU = "setup/countries/modded/mTAU.txt"
TAW = "setup/countries/modded/mTAW.txt"
TAY = "setup/countries/modded/mTAY.txt"
TAZ = "setup/countries/modded/mTAZ.txt"
TBA = "setup/countries/modded/mTBA.txt"
TBB = "setup/countries/modded/mTBB.txt"
TBC = "setup/countries/modded/mTBC.txt"
TBD = "setup/countries/modded/mTBD.txt"
TBE = "setup/countries/modded/mTBE.txt"